127,128,23,23,23,23,23,23,23,128,127
127,128,23,23,23,23,23,23,23,128,127
127,128,23,23,23,23,23,23,23,128,127
127,128,23,23,63,63,63,23,23,128,127
127,128,23,23,63,28,63,23,23,128,127
127,128,23,23,63,63,63,23,23,128,127
127,128,23,23,63,29,63,23,23,128,127
127,128,23,23,63,63,63,23,23,128,127
127,128,23,23,23,23,23,23,23,128,127
127,128,23,23,23,23,23,23,23,128,127
127,128,23,23,23,23,23,23,23,128,127