2,2,1,1,1,2,2,2,2,1,1
2,2,2,2,2,2,2,2,2,2,1
3,2,2,2,2,2,2,2,2,2,2
3,3,2,2,2,3,3,3,3,3,2
4,3,3,3,3,3,5,5,5,3,3
4,4,3,3,5,5,5,5,3,3,3
56,4,5,5,5,5,5,3,3,3,3
6,5,5,5,5,5,5,3,3,3,3
6,6,5,5,5,5,5,5,3,3,6
6,6,5,5,5,5,5,5,5,6,6
6,5,5,5,5,5,5,5,6,6,56