5,5,58,58,5,5,5,58,58,5,5
5,5,5,5,5,5,5,5,5,5,5
58,5,5,5,56,5,56,5,5,5,58
58,5,5,5,5,5,5,5,5,5,58
5,5,56,5,5,5,5,5,56,5,5
5,5,5,5,5,62,5,5,5,5,5
5,5,56,5,5,5,5,5,56,5,5
58,5,5,5,5,5,5,5,5,5,58
58,5,5,5,56,5,56,5,5,5,58
5,5,5,5,5,5,5,5,5,5,5
5,5,58,58,5,5,5,58,58,5,5