5,5,5,3,3,3,3,3,5,5,5
5,5,5,3,3,3,3,3,5,5,5
5,5,5,3,3,3,3,3,5,5,5
5,5,26,26,26,26,26,26,26,5,5
5,5,64,64,64,64,64,64,64,5,5
5,5,64,64,64,64,64,64,64,5,5
5,5,64,64,64,64,64,64,64,5,5
5,5,27,27,27,27,27,27,27,5,5
5,5,5,3,3,3,3,3,5,5,5
5,5,5,3,3,3,3,3,5,5,5
5,5,5,3,3,3,3,3,5,5,5