3,51,73,73,73,73,73,73,73,73,3
51,73,64,64,64,64,64,64,64,73,3
73,64,64,54,64,64,54,55,64,73,73
53,73,64,64,64,64,64,64,64,73,3
3,53,73,64,73,73,73,64,73,73,3
3,3,3,64,3,3,3,64,3,3,3
3,51,73,64,73,73,73,64,73,73,3
51,73,64,64,64,64,64,64,64,73,3
73,64,64,54,64,64,54,55,64,73,73
53,73,64,64,64,64,64,64,64,73,3
3,53,73,73,73,73,73,73,73,73,3