6,6,5,5,5,5,5,5,5,5,5
6,6,5,5,5,5,5,5,5,5,5
6,56,5,5,5,5,5,5,5,56,6
5,5,5,5,5,5,5,5,6,6,6
5,5,5,5,5,5,5,56,6,6,5
6,5,5,5,5,5,56,6,6,5,5
6,6,56,5,5,5,5,5,5,5,5
6,6,5,5,5,5,5,5,5,5,5
6,5,5,5,5,5,5,5,56,5,5
5,5,5,5,5,5,5,5,6,6,5
5,5,5,5,5,5,5,6,6,6,6