23,23,23,23,23,23,23,23,23,23,23
23,23,23,23,23,23,23,23,23,23,23
128,128,128,23,23,23,23,23,128,128,128
127,127,128,23,23,23,23,23,128,127,127
127,127,128,23,23,23,23,23,128,127,127
127,127,128,128,23,23,23,128,128,127,127
127,127,128,23,23,23,23,23,128,127,127
127,127,128,23,23,23,23,23,128,127,127
128,128,128,23,23,23,23,23,128,128,128
23,23,23,23,23,23,23,23,23,23,23
23,23,23,23,23,23,23,23,23,23,23