4,5,5,5,5,5,5,5,4,3,2
4,4,5,5,5,5,5,4,3,3,3
3,4,4,4,5,5,5,4,4,5,5
2,3,3,3,4,4,4,4,5,5,5
3,3,4,4,4,4,3,3,5,5,5
5,4,4,4,4,3,3,4,4,5,5
5,5,4,4,4,4,4,4,4,4,5
5,3,4,4,5,5,5,4,4,4,4
3,3,4,5,5,5,5,4,4,4,3
3,4,4,5,5,5,5,5,4,3,2
4,4,5,5,5,5,5,5,4,4,3