7,5,5,5,5,5,7,7,7,7,56
7,5,5,5,5,5,7,7,7,7,7
7,7,5,5,5,5,5,7,7,7,7
7,7,5,5,5,5,5,5,56,7,7
7,5,5,5,5,5,5,5,5,7,7
7,5,56,7,5,5,5,5,5,7,7
7,5,7,7,5,5,5,5,5,5,7
7,5,7,7,56,5,5,5,5,5,7
7,5,7,7,7,5,5,5,5,5,7
7,5,5,7,7,5,5,5,5,5,5
7,7,5,5,5,5,5,5,5,5,5