127,127,127,127,127,127,128,63,63,128,127
127,127,127,127,127,127,128,63,63,128,127
128,128,128,128,128,128,128,63,63,128,128
63,4,4,63,63,63,63,63,63,63,63
63,63,63,63,63,63,63,63,63,63,63
63,63,63,63,63,63,63,63,63,63,63
63,63,63,126,63,63,126,63,63,63,63
63,126,126,63,63,126,57,63,63,63,63
128,128,128,128,128,128,128,128,128,128,128
127,127,127,127,127,127,127,127,127,127,127
127,127,127,127,127,127,127,127,127,127,127