6,6,6,5,5,5,5,5,6,6,6
6,6,5,5,5,5,5,5,5,6,6
6,5,5,5,58,58,58,5,5,5,6
5,5,5,5,5,5,5,5,58,5,5
5,5,58,5,5,5,5,58,58,5,5
5,5,58,5,5,76,5,5,58,5,5
5,5,58,58,5,5,5,5,58,5,5
5,5,58,5,5,5,58,5,5,5,5
6,5,5,5,58,58,58,5,5,5,6
6,6,5,5,5,5,5,5,5,6,6
6,6,6,5,5,5,5,5,6,6,6