9,9,9,8,5,5,5,8,56,9,9
9,9,8,5,5,5,5,5,8,56,9
9,56,5,5,5,5,5,5,5,8,8
56,5,5,5,5,9,9,5,5,5,5
5,5,5,9,5,5,9,5,8,5,5
5,5,5,9,9,5,5,5,9,9,5
5,8,5,5,5,5,5,5,9,8,5
8,9,8,5,5,5,5,56,9,8,8
9,9,5,5,5,5,5,5,5,5,9
9,8,5,5,5,5,5,5,5,56,9
56,8,8,5,5,5,5,5,5,9,9